a	a
ai	ai
au	au
b	b
e	e
g	g
h	h
i	i
k	k
K	K
kh	kh
l	l
m	m
M	M
MM	MM
n	n
N	N
NG	NG
nn	nn
NN	NN
NNG	NNG
ng	ng
o	o
oo	oo
p	p
ph	ph
P	P
s	s
si	si
t	t
T	T
th	th
ts	ts
tsh	tsh
tshi	tshi
tsi	tsi
u	u
w	w
y	y
